o x o x o
o o o x x
o o o o o

o o o o o
o o x o o
o o x o o
o o x o o
o o o o o